10 15
_ _ _ _ _ _ _ _ _ _
_ _ _ _ _ _ _ _ _ _
_ _ _ _ x _ x _ _ _
_ _ _ x _ _ _ _ _ _
_ _ _ x _ _ _ _ _ _
_ _ _ x _ _ _ _ _ _
_ _ _ x _ E _ _ _ _
_ _ _ x _ _ _ E _ _
_ _ _ x _ _ E E _ _
_ _ _ x _ _ E E _ _
_ _ _ x _ _ E E E _
_ P _ x _ E E _ _ _
_ _ _ _ _ _ _ _ _ _
_ _ P x _ E _ _ _ _
_ _ _ x _ _ _ _ _ _
